11111111111111
10000000000C01
100000000000E1
10P00000000C01
10000000000C01
11111111111111
