11111111111111
10000000000C01
100000000000E1
10000000000C01
10000000000C01
111111111111111
